unlock door :: key
kill monster :: ogre
carry water :: bottle
wash floor :: sponge
catch butterfly :: net
reach roof :: staircase
study geometry :: textbook
enter castle :: drawbridge
enter spaceship :: airlock
take bath :: bathtub
activate machine :: switch
get hired :: application
block light :: curtain
outwit enemy :: plan
make money :: job
call friend :: telephone
go swimming :: swimsuit
open box :: lid
open jar :: lid
create painting :: paintbrush
become wealthy :: money
write program :: computer
quench thirst :: water
become famous :: publicity
repair car :: tool
go fishing :: tackle
study microbes :: microscope
swat fly :: flyswatter
make sandwich :: bread
bake pie :: oven
steer horse :: bridle
win game :: strategy
